essen=jíst
trinken=pít
die Kartoffel=brambor
das Obst/die Frucht=ovoce
der Salat=salát
der Käse=sýr
die Wurst=salám
der Reis=rýže
die Milch=mléko
das Gemüse=zelenina
das Wasser=voda
der Wein=víno
die Butter=máslo
das Fleisch=maso
der Fisch=ryba
das Glas=sklenice
das Bier=pivo
das Brot=chléb
die Gabel=vidlička
der Löffel=lžíce
der Teller=talíř
das Messer=nůž
das Ei=vejjce
der Kuchen=koláč
der Hamburger=hamburgr
die Orange=pomeranč
der Saft=šťáva
der Tee=čaj
die Suppe=polévka
die Marmelade=marmeláda
Pommes frites=hranolky
das Brötchen=houska
das Wurstbrot=chléb se salámem
das Käsebrot=chléb se sýrem
das Hänchen=kuře
das Kotelett=kotleta
das Eis=zmrzlina
das Ketschup=kečup
das Mineralwasser=minerálka
die Flasche=láhev
die Dose=krabička/plechovka
die Tasse=šálek
der Kaffee=káva
erzählen=vyprávět
morgens=v ráno
der Mittag=poledne
mittags=v poledne
der Nachmittag=odpoledne
abends=večer
mögen=mít rád
glauben=myslet
das Interview=interview
markieren=označit
gern=rád
lieber=raději
manchmal=někdy
der Gasthof=hostinec
kalt=studený
das Gericht=pokrm
das Toastbort=toastový chléb
die Fischplatte=rybí mísa
der Schinken=šunka
die Gurke=okurka
Rind...=hovězí...
dei Zwiebel=cibule
Haupt...=hlavní...
Schwein...=vepřový...
der Braten=pečeně
das Kohl=zelí
das Steak=steak
die Bohne=fazole
Brat...=pečený...
die Bratwurst=pečená klobása
das Dessert=dezert
die Sahne=smetana
der Apfel=jablko
das Getränk=nápoj
nehmen=brát
die Nachspeise/der Nachtisch=zákusek
danach=potom
die Speisekarte=jídelní lístek
bestellen=objednat
bekommen=dostat
der Weißwein=bílé víno
der Mann=muž
bezahlen=platit
zusammen=společně
getrennt=zvlášť
oben=nahoře
vergleichen=porovnat
fantastisch=fantastický
etwas=něco
genug=dost
das Abendessen=večeře
kochen=vařit
selbst=sám
zuerst=nejprve
die Vorspeise=předkrm
sauer=kyselý
süß=sladký
warm=teplý
bitter=hořký
trocken=suchý
hart=tvrdý
salzig=slaný
scharf=ostrý
frisch=čerstvý
fett=tučný
die Soße=omáčka
die Lebensmittel=potraviny
der Markt=trh
der Fachmarkt=trh pro odborníky
der Sekt=šampaňské
die Packung=balení
das Stück=kus
das Vollkornbrot=celozrný chléb
der/das Joghurt=jogurt
die Erdbeere=jahoda
die Kirsche=třešeň
die Himbeere=malina
die Brombeere=ostružina
die Tomate=rajče
das Öl=olej
der Zucker=cukr
das Gewürz=koření
der Pfeffer=pepř
das Mehl=mouka
die Salami=trvanlivý salám
der Aufschnitt=nřez
die Nuss=ořech
die Schokolade=čokoláda
das Mittel=prostředek
das Waschmittel=prací prostředek
das Spmittel=mycí přípravek
nah=blízký
die Anzeige=inzerát
das Angebot=nabítka
das Sonderangebot=mimořádná nabídka
die Kuste.bedna
das Pfund=libra
das Kilo=kilo
das Gramm=gram
der Liter=litr
der Cent=cent
der Zettel=lístek
der Einkaufszettel=lístek na nákup
brauchen=potřebovat
das Frühstück=snídaně
das Mittagessen=oběd
der Freund=přítel
feiern=slavit
das Geschirr=nádobí
die Wäsche=prádlo
backen=péct
das Lexikon=naučný slovník
am liebsten=nejraději
der Durchschnitt=průměr
jeder=každý
der Deutsche=Němec
die Deutsche=Němka
pro Jahr=za rok/ročně
beliebt=oblíbený
das Efrischungsgentränk=osvěžující nápoj
es gibt=je/existuje
alle=všechny
verschieden=různý
die meisen=většina
Lieblings...=oblíbený...
die Lieblingssorte=oblíbený druh
kennen=znát
wichtig=důležitý
sehr=velmi
der Unterschied=rozdíl
man trinkt=pije se
vor allem=především
mischen=míchat
stark=silný
der Alkohol=alkohol
normal=normální
hell=světlý
mild=jemný
der Raum=místnost
dort=tam
erkennen=poznat
sofort=okamžitě
hoch=vysoký
schlank=štíhlý
der Export=export
herb=trpký
so=tak
Bayern=Bavorsko
die Republik=republika
tschechisch=český
besonders=zejména
sondern=nýbrž
überall=všude
typisch=typický
der Bauch=břicho
eng=úzký
der Weizen=pšenice
vorwiegend=převážný
doch=přece
Nord...=severní...
West...=západní...
Ost...=východní
Süd...=jižní...
groß=velký
unten=dole
welcher=který
die Situation=situace
schwierig=obtížný
der Gast=host
das Würstchen=párek
tut mir leid=je mi to líto
Verzeihung!=Promiňte!
überhaupt=vůbec
nun=no
das Beispiel=příklad
zum Beispiel=například
das Omelett=omeleta
eintragen=zapsat
die Tabelle=tabulka
