das Aussehen=vzhled
dick=tlustý/-ě
duenn=tenký/tence/hubený/-ě
traurig=smutný
froehlich=veselý/-e/radostný/-ě
huebsch=pěkný/-ě/hezký/-y
haesslich=ošklivý
der Hut=klobouk
die Brille=brýle
das Hemd=košile
die Hose=kalhoty
der Schuh=bota
das Kleid=šaty (dámské)
der Strumpf=punčocha
die Bluse=blůza/halenka
der Rock=sukně
aussehen=vypadat
Wie hat das Kleid ausgesehen?=Jak ty šaty vypadaly?
ziemlich=dost/značně
Er ist ziemlich alt.=Je dost starý.
etwa=asi/přibližně
Er ist etwa 60.=Je mu asi 60.
jung=mladý/-ě
schlank=štíhlý/-e
Wie finden Sie ...?=Jak se vám líbí ...?
Brigitte sieht huebsch aus, finde ich.=Podle mě vypadá Brigitte hezky.
Ich finde, Hans sieht sehr intelligent aus.=Podle mě vypadá Hans velmi inteligentně.
dumm=hlupý/-ě
freundlich=přátelský
gemuetlich=přijemný/-ě/útulný/-ě
komisch=divný/-ě/zvláštní/-ě
langweilig=nudný/-ě
lustig=veselý/-e
nervoes=nervózní/-ě
nett=milý/-e
ruhig=klidný/-ě
sympathisch=sympatický/-y
vergleichen=srovnávat
Wer ist am groessten?=Kdo je největší?
Ich glaube, Peter ist am aeltesten.=Myslím, že Peter je nejstarší.
Sie ist viel kleiner als ich.=Ona je mnohem menší než já.
sich vorstellen=představit se
Hast du dich schon vorgestellt?=Představil ses už?
Was glauben Sie, wer ...?=Co myslíte, kdo ...?
das Gedaechtnis=paměť
ansehen=podívat se/prohlédnout si (něco,někoho)
genau=přesný/-ě
Sehen Sie das Bild genau an.=Prohlédněte si pozorně ten obrázek.
gehoeren=patřit (k někomu, něčemu)
das Gesicht=obličej
rund=kulatý
schmal=úzký/úzce
lang=dlouhý
die Nase=nos
der Mund=ústa/pusa
das Auge=oko
der Hals=krk
das Bein=noha
der Arm=ruka/paže
kurz=krátký/krátce
rot=červený
blau=modrý
gruen=zelený
gelb=žlutý
braun=hnědý
schwarz=černý
weiss=bílý
grau=šedý
der Ehemann=manžel
sportlich=sportovní
elegant=elegantní
der Spruch=rčení/přísloví
klug=chytrý/chytře
reich=bohatý
meistens=většinou
selten=zřídka
treu=věrný
die Sorge=starost
der Feind=nepřítel
voll=plný
der Bauch=břicho
Das finde ich nicht.=To si nemyslím.
Das glaube/meine ich auch.=To si také myslím.
Das ist doch nicht wahr.=To přece není pravda.
Das ist Unsinn.=To je nesmysl.
Das ist ein Vorurteil.=To je předsudek.
der Chef=šéf/vedoucí
die Chefin=šéfová/vedoucí
der Kollege=kolega
die Kollegin=kolegyně
der Nachbar=soused
ledig=svobodý/svobodná
immer=vždy(cky)
oft=často
manchmal=děkdy
nie=nikdy
gefaehrlich=nebezpečný
interessant=zajímavý
der Tipp=tip/rada
vorher=předtím/dríve
nachher=potom
die Angestellte=zamšstnankyně
der Angestellter=zaměstnanec
das Haar=vlas
die Kleidung=oblečení
die Meinung=názor
Wir waren der Meinung: ...=Byli jsme toho názoru, že ...
der Mut zu ...= odvaha k ...
die Jacke=vesta/bunda
konsrvativ=konzervativní/-ě
die Frisur=účes
Das steht dir nicht.=To ti nesedí.
gefallen=líbít se
Das gefaellt mir besser.=To se mi líbí víc.
Hat es Ihnen gefallen?=Líbí se vám to?
tragen=nosit (oblečení)
Frueher hat sie immer nur Hosen getragen.=Dříve nosila vždycky jen kalhoty.
weich=měkký/měkce
wirken=(za)působit
der Anzug=oblek/šaty(pánské)
die Krawatte=kravata
Was fuer einen Anzug traegt er gern?=Jaký oblek nosí rád?
Was fuer Schuhe hat sie getragen?=Jaké měla boty?
anziehen=obléci/oblékat
die Hochzeit=svatba
Was ziehst du denn zu der Hochzeit an?=Co si oblékneš na svatvu?
der Bruder=bratr
meinen=myslet/mínit
Wen meinst du?=Koho myslíš/míníš?
der Test=test
der Punkt=bod
der Park=park
verrueckt sen=být blázen
Die Leute sind doch verrueckt!=Ti lidi jsou blázni/ se zbláznili!
wunderbar=báječný/-ě
die Hausarbeit machen=dělat domácí práce
Dieser arme Mann!=Ten ubohý muž!/Ten chudák!
manche Eltern=někteří rodiče
jeder Mensch=každý člověk
die Tochter=dcera
jedenfalls=v každém případě/každopádně
stecken=vězet
an der Haltestelle stehen=stát na zastávce
de Wagen=vůz
bis zum Morgen feiern=slavit až do rána
anrufen=(za)volat/(za)telefonovat
einladen=pozvat/zvát
das Ergebnis=výsledek
ehrlich=čestný/poctivý
puenktlich=přesný/dochvilný
stark=silný
kritisieren=kritizovat
angenehm=příjemný
offen=otevřený
das Geld=peníze
arbeitslos sein=být nezamestnaný
die Arbeitslose=nezamšstnaná
der Arbeitloser=nezamšstnaný
das Arbeitsamt=pracovní úřad
der Beamte=úřeník/státní zaměstnanec
jeden Morgen=každé ráno
das Badezimmer=koupelna
die Mitte=střed
mittler=střední
die Stelle=místo/zaměstnání
das Angebot=nabídka
der Arbeitgeber=zamšstnavatel
die Firma=firma
zufrieden=spokojený
aergern=zlobit/štvát
Sie haben ihn geaergert.=Zloboli/Štvali ho.
kuendigen=dát výpověď
der Job=job/práce/zaměstnání
der Prozess=proces
einen Prozess gegen ... fuehren=vést (soudní) proces proti ...
der Rechtsanwald=advokát
Das ist mir egal/gleich.=To je mi jedno.
Meinetwegen kann er ...=Pro mě za mě může ...
verlangen=žádat/požadovat/vyžadovat
hat er Geld verlangt?=Žádal peníze?
wieder=zase/znovu
zahlen=(za)platit
Sonst bekommt er kein Geld.=Jinak nedostane peníze.
die Leistung=výkon
Da bin ich anderer Meinung.=Na to mám jiný názor.
luegen=lhát
Er hat nie gelogen.=Nikdy nelhal.
aendern=(z)měnit
Er hat sein Aussehen nicht geaendert.=Nezměnil svůj vzhled.
Sie haben recht!=Máte pravdu!
Das ist wahr.=To je pravda.
Genau!=Přesně tak!
Einverstanden!=Souhlasím.
Da bin ich nicht sicher.=To si nejsem jistý.
Das ist falsch.=To není správně./To je špatně.
Das stimmt, aber ...=To je pravda, ale .../To souhlasí, ale ...
