bloke=chlápek/maník
allege=prohlásit bez důkazů
flagellate/flog=mrskat/bičovat
clairvoyance=jasnozřivost/jasnovidnost
sagacious=moudrý/prozíravý/chytrý
grate=rošt/mřížka/strouhat
barred=zamřížovaný
infirmary=ošetřovna
attest=svědčit/potvrdit
awful=strašný/hrozný
grisly=příšerný/strašlivý
bearing=ložisko/držení těla/způsoby chování/azimut
aviation=letectví/létání
jibe=posměšek/posměšná poznámka
tout=vnucovat/podstrkovat
heir=dědic
infallible=neomylný
aviate=letět
levy=odvod/poplatek/zabavit/uvalit
veil=závoj/rouška
bewail=naříkat/oplakávat
apparition=zjevení
incur=způsobit/přivodit/zapříčinit
drawl=mluvit pomalu/převalovat slova
token=žeton
picturesque=malebný/pitoresktní
grimy=špinavý/černý
grime=zašpinit/zamazat/špína/nečistota
pry=slídit/pátrat
snoop=čmuchat/slídit/šmírovat
abacus=počítadlo
flap=třepat/plácat/klapka
abase=ponížit/pokořit
abnegate=vzdát se/zříct se
scrappy=útržkovitý/nesouvislý
composure=klid/rozvaha/vyrovnanost
gospel=evangelium/slovo boží
drapery=drapérie/závěs
brink/verge=pokraj/okraj
thump=rána/bušit/žuchnutí
lumbering=hlučný/těžkopádně se pohybující/těžba dřeva
altercation=hádka/ostrý spor
grovel=plazit se/ponižovat se
festoon=ozdobit/ověšet/girlanda
ensnare=polapit/chytit/podmanit si
screech=pištět/ječet
chatter=brebentit/klábosit/drkotat/cvakat
unsubstantiated=nepodložený/neopodstatněný
holler/bellow=křičet/řvát
sultry=dusný/parný/smyslný/rozpálený
stifling=dusivý/potlačující
buttress=opěra/podpořit/opěrný pilíř
shrivel=scvrknout se/seschnout/vráštit se
prerogative=výsada/přednostní právo
shirk=vyhnout se/vyhýbat se/utéct před něčím
impious=bezbožný/hříšný/rouhavý
forlorn=opuštěný/pustý/osamocený
palpable=zřejmý/hmatatelný
inter=pohřbít
fledgling=ptáče/zelenáč
commendable=chválihodné
insurrection=vzpoura/povstání
slash=říznout/rozseknout
commission=pověřit/zadat
demur=namítat/váhat
vie=soupeřit/přetahovat se
gizmo=udělátko/věcička
trance=trans
entrance=vchod
entry=vstup/záznam/položka
chapel=kaple
christen=křtít
congratulatory=blahopřejný
shore=pobřeží/opěra
eternity/perpetuity=věčnost
partridge=koroptev
dove=holub/holubice/hrdlička
hen=slepice
wilt=vadnout/sesychat
swallow=vlaštovka/spolknout
bed bug=štěnice
effrontery=drzost/nestydatost
yuck=fuj/ble
henchman=stoupenec/kumpán
mobster=mafián/člen gangu
pique=uraženost/rozhněvat/vyvolat
poignant=ostrý/výstižný/dojímavý
gnash=skřípat zuby
twit=pitomec/hňup
wright=řemeslník/výrobce
cuckoo=kukačka
cesspool/cesspit=žumpa/jímka
swath=řádek/pokos/záber
strident=hlasitý/ostrý/pronikavý
bunk=lůžko/palanda/blbost
prolixity/circuitousness=rozvláčnost
circuitous=rozvláčný/oklikou/neupřímný
callous=bezcitný/bezohledný/mozolovitý
clique=parta/klika
mistress=milenka/paní
