vindication=ospravedlnění
tie=kravata/svázat
obstruct=bránit/(za)blokovat
liteunant=poručík
dizzy=mající závrať
pebble=oblázek
puddle=louže
disenherit=vydědit
accuse/indict=obvinit
stem=pramenit z něčeho/stonek
franchise=povolení/franšíza/volební právo
disenfranchise=vyloučit/zbavit hlasovacího práva
pasty=mazlavy/bledý
pesky=otravný
bead=korálek
bromide=bromid/banalita
pincer=kleště/pinzeta/klepeto
slump=propad/prudce poklesnout
penance=pokání
scab=strup
picket=postavit hlídky/stávkovat
strike=stávka
derelict=opuštěný/zchátralý
incision=(zá)řez
hold on/hold out=vydžet
glance=pohlédnout
chip in=přispět/složit se
embark=pustit se do něčeho/nastoupit
statutory=statutární/zákonný
stature=vzrůst/postava
tacid=tichý/mlčenlivý
plight=tíživá situace/slibit
slag=coura/struska
narrator=vypravěč
streak=pruh/pás
plaster=omítka/náplast
popper=patentka/druk
conceit=domýšlivost
renunciation=odřeknutí
renounce=odvolat/zrict se
enounce=vyslovit/prohlásit
enunciation=vyslovení/výslovnost
denounce=odsoudit/vypovědět
denunciation=(verejne) odsouzeni/odmitnuti
tile=dlaždice/kachlík
stern=přísný/vážný/záď
vestige=stopa/znamka/pozustatek
province=provincie/pole působnosti
harness=postroj/ovládnout/využít
impediment=překážka
engulf=pohltit/zachvátit
disfigure=znetvořit
destitute=stradajici/nemajetný/opusteny
gulch/ravine=rokle/strž
jury=porota
marble=mramor
dial=číselník/vytočit
sudden=náhlý
mason=zedník
peddler=podomní prodejce
eminent=vynikajici/vyznamny
imminent=bezprostřední
ditch=příkop/zbavit se
hog=prase/zabrat (si)
carriage=vozík/kočár
martial=válečný
mayor=starosta/primátor
sanctity/sacrament=posvátnost
torrent=prudký proud/příval
detergent=čistící prostředek
determine=určit
deteriorate=zhoršit
ebb=klesat/ustupovat
courteous=zdvořilý
peck=klovat/zobat
scuff=odřít
scoff=posměch/vysmívat se
scrape=oškrabat/seškrabat
remark=poznámka/připomínka
intelligible=srozumitelny
unintelligible=nesrozumitelny
dept=oddeleni
accountable=odpovedny
plummet=prudce poklesnout
compartmentalize=rozclenit
incarceration=uvezneni
oblivious=nevsimajici si
obvious=zrejmy
extensible=rozsiritelny
extensive=rozsahly
truncate=odriznout/seriznout
defer=odlozit
corresponding=odpovidajici
brimstone/sulphur=sira
elect=zvolit
clerk=urednik
spruce=smrk
jerk=blbec/trhnout/skubnout
bogged=zapadly
abdicate/resign=odstoupit
