hum=hucet/bzucet
subvention/subsidy=statni podpora
putsch=puc/prevrat
exhort=vyzvat/nabadat
exhortation=nabadani
busk=hrat na ulici za penize
babel=vrava/ramus/zmet
cognizance=vedomost/povsimnuti/vzit na vedomi
faze=otravovat/trapit
irrespecttive=bezohledny/nehlede/bez ohledu
contrary=opacny/proti
contradictory=sporny/protikladny/neslucitelny
yeast=kvasnice/drozdi/kvas
concatenate=zretezit/spojovat
reel=civka/spulka/motat/navijak
bumble=zmatene chovani/bzucet/dunet
boom=hucet/uspech/vzestup
waver=kolisat/vahat
scorch=ujizdet velkou rychlosti/spalenina/popalit
duress=natlak/donuceni/pohruzka
extort=vynutit hrozbami/nasilim
muzzle=cenich/hlaven
shabby=omsely/zchatraly/nepoctivy/necestny
kennel=bouda pro psa/kotec
myriad=myriada
render=ucinit
bile=zluc/rozmrzelost
vex=suzovat/trapit
vexed=rozmrzely/otravovany
determinately=rozhodne/urcite
solemnly=vazne/slavnostne
faint=bazlivy/chaby
hint=naznak
flaunt=chlubit se necim
disgrace=ostuda/hanba/potupa
grace=elegance/ladnost/laskavost/milost
flicker=trepotani/trepotat se
splash=cakat/splichat
wistful=tesklivy/posmutnely
prowl=cihana/lov/plizit se
cushy=pohodlny/nenarocny
cushion=tutlat/zmirnit/poduska
possessive=privlastnovaci/majetnicky
tiara=tiara/diadem/celenka/korunka
sustenance=vyziva/strava/obziva/zivobyti
bubsistence=existencni/vyziti/zivotni minimum
enticing=lakavy/svudny
entice=nalakat/zlakat/poutat
deranged=vysinuty/nepricetny/rozruseny
shroud=rouska/rubas/zavoj/clona
dome=kupole/klenba
domed=klenuty/kupolovity
steeple=kostelni vez/spicata vez
scoop=shrabnout/nabrat/lopatka/sberacka
digress=odbocit/odchylit se
hike=vylet/jit na turu
hitchhike=stopovat/cestovat (auto)stopem
hitchhiker=stopar
shunt=odsunout/odlozit/odklad
scamper=pelasit/poskakovat
silhouette=silueta
crunch=chroupat/krupat
crouch=skrcit se/krcit se
dowsing=proutkareni
lavish=bohaty/plytvat
endure=vydrzet/vytrvat
lurk=skryvat se/cihat
persistent=trvaly/staly
sustain=udrzet/zachovat
leash=uvazat/voditko
slack=mdly/flakat se
zeal=horlivost/zapal
enthusiasm=nadseni/zaliba
vigor/vigour=verva/raznost
compliant=poddajny/vyhovujici
complicit=majici spoluvinu
outlet=odbytiste/odtok
outlook=vyhled/vyhlidka
stuffy=usedly/zatuchly/ucpatny
dank=vlhky/zatuchly
indignant=rozhořčený
shell shock=posttraumatický válečný stres
shell=skořápka
implore=upenlive prosite/vzyvat/zaprisahat
entitle=davat pravo/zmocnit
entitled=opravneny/majici narok
luminary=kapacita/autorita
luminous=svitici/svitivy/zarici
deceit=podvod/klam
property=vlastnost/majetek
plummet=padat/prudce klesnout
frill=limec/zachranny zahyb
embellish=okraslit/ozdobit
rote=mechanicke opakovani
ruthless=bezohledny/nelitostny
girder=nosnik/traverza
beam=papersek/nosnik
aloof=odmereny/odtazity/stranit se
perspicacious=bystry/proziravy
snappy=pohotovy/usecny
