nausea=nevolnost
condone=prehlizet/prominout
entail=znamenat
damping=tlumeni
abhor=hnusit si
slant=svazovat se/sklon
sly=mazany
slug=slimak
dispatcher/sender=odesilatel
conceal=skryt/skryvat
omission=opomenuti/vynechani
floppy=zplihly/sveseny
derisive/mocking=posmesny
deride/mock=vysmivat se
implacable=nesmiritelny
convulsive=krecovity
bud=pucet/pupen
commiseration=politovani/soucit
ostentatious=okazaly
mogul/tycoon=magnat
abrupt=nahly/neocekavany
severity=vaznost/kriticnost
sever=odseknout/oddelit
sewer=kanalizace/stoka
disown=poprit/zrici se
privation=nouze/stradani
ordeal=utrpeni/tezka zkouska
secede=vystoupit/odtrhnout se
haphazard=nahodilost
harbour=pristav/poskytnout utociste/skryvat/chovat
scud=uhanet/hnat se
fugitive=uprchlicky/kocovny/potulny
roguish=darebacky
rogue=darebak
mournful=truchlivy
mourn=truchlit
hiccup=zadrhel/skytnuti
onerous=obtizny/tizivy
shiver=zatrast/zachvet se/zachveni
mundane=vsedni/obycejny
prolific=plodny/produktivni
stipulate=vyhradit si/vyminit si
contort=zkroutit (se)
stooge=panak/poskok
dinky=hezoucky
decrepit=vetchy/sesly
hamper=branit/prekazet
rake=hrabe/shrabnout
reek=pachnout/smrdet
thereof=z toho/z nich
entrench=opevnit/usadit/obehnat zakopem
ditto=taktez/totez/rovnez
diffidence=ostych/nesmelost
terse=strucny/strohy/usecny
befit=sluset se/hodit se
freight=dopravne/naklad
cogency=padnost/presvedcivost
proposition=tvrzeni
statement/declaration=prohlaseni
proverb=prislovi
parse=analyzovat (vetu)
edification=osveta/pouceni
sanction=schvalit/sankce
couch=gauc/formulovat/vyjadrit
disguise=prestrojit/zamaskovat/prestrojeni
baldly=stroze
amalgamate=sloucit (se)
lawn=travnik
as it were=takrikajic
cab=taxik/kabina
cabbie/cab driver=taxikar
stove/heater=kamna
cooker/stove=sporak
dart=sipka
engender=navodit
stunted=zakrnely
rivet=nyt/snytovat
solace=utecha
focal=ohnisko
inerrant=inerrantni/bezchzbny
dew=rosa
municipal=obecni/mestsky
recede=ustupovat/vzadlovat se/mizet
defraud=osidit/podvest
garment=cast odevu/odev
plumb=kolmy/primy
plumbing=klempirstvi/instalaterstvi
gaunt=vyzably
contortion=zkrouceni
callus=mozol
collude=tajne/ilegalne se dohodnout
collusion=tajna/ilegalni dohoda
despicable=opovrzenihodny
ringer=zvonik/dvojnik
audacious=odvazny/drzy
vacant=neobsazeny/volny
incumbent=drzitel/obyvatel
possess=ovladnout/mit
plausible=prijatelny/pravdepodobny
terrestrial=pozemni/suchozemsky
