extraterrestrial=mimozemsky
gills=zabry/lupeny hub
proponent=zastance
submarine=ponorka/podmorsky
comprehension=chapani
understanding=porozumeni
ordinance=predpis/narizeni
profane=rouhavy/svetsky
rely=spolehnout se/byt zavisly
passage=pruchod
provenance=puvod
regiment=systematicky zorganizovat/pluk
redirect=presmerovani
leaflet=letak
sag=prohybat se/provesit se
exult=jasat/plasat
exultant=plesajici
jubilant=jasavy
minute=malicky/minuta
comminute=premenit na kousicky
pulverize=znicit/rozdrtit
precept=zasada/predpis
concern=znepokojeni
content=obsah/spokojeny
contentment=spokojenost
infidelity=nevera
incommensurable=nesoumeritelny
hypotenuse=prepona
vernacular=lidovy
blow (nose)=smrkat
kychat=sneeze
kuckat=choke
neat=uhledny/upraveny
weld=svarovat/svar
grumble=reptat
ostensive=zdanlivy
nonchalant=nenuceny
woven=tkany
slavish=otrocky
incarcerate=vsadit do vezeni/zavrit
upshot=vysledek/zaver
flinch=couvnout/ucuknout
breadth=sirka
trite=banalni
unrequit=neopakovat
treaty=dohoda
vagary=rozmar/vrtoch
couche=vyjadrit/formulovat
ramify/fork=rozvetvit
propitiatory=smirlivy/smirci
rug=hadr/maly koberec
ruffler=vagabond rogue or beggar
ruff=okruzi
spasm=krec
prism=hranol
exhurbetant=energicky/bujny
mirrage=opticky klam
emergence=vznik/objeveni se
emergency=zachranny/pohotovostni
fleeting=prchavy/pomijivy
valuation=ocenovani/ohodnoceni
evaluation=vyhodnoceni
brisk=hbity/zivy
hat/toque/beanie=cepice
egregious=pozoruhodny
smother=tutlat/zakryt/zadusit
imperious=panovacny
rush=chvatat/spech
wither=ch≈ôadnout
interim=interval/prozatimni
transliteration=transliterace/prepis
rendition=ztvarneni/provedeni
scutter=cupitat
scuttling=cupitani/cupitajici
beet/beetroot=repa (cervena)
syncope=docasene bezvedomi/mdloba
nook=kout
profound=hluboky/vazny/opravdovy
predominant=prevladajici
query=dotazat se/dotaz
earthen=hlineny/kameninovy
earthenware=hrncirske/hlinene/kameninove zbozi
coarse=surovy/neobrobeny/hruby
shrewd=chytry/bystry/mazany
shrub=krovi/ker
luggage=zavazadla/brasnarske zbozi
upbraid=karat/kritizovat
glade=mytina/misto v lese bez stromu
beligerent=nepratelsky/valcici/agresivni
whistle=piskat/hvizdat/pistal(k)a
electorate=volici/volicstvo
commensurate=soumeritelny/umerny/primereny
denizen=obyvatel
tackle=obtezovat/resit
pulley=kladka
painstaking=usilovny/peclivy
morass=bazina/mocal/bahno
sawing=rezani/rezajici
muffler=sala/tlumic
chassis=plast konstrukce/podvozek/sasi
