streek=pruh/protáhnout
shriek=(za)ječet
rumble=rachot/rachotit
ramble=mluvit/chodit bez cíle
rave=blouznit/třeštit
miscarriage=samovolný potrat/nezdar
peddle=prodávat podomně
poultry=drůbež
watershed=předěl/přelom
cursory=zběžný
acolyte=přívrženec/ministrant
domineer=vládnout despoticky
thorough=důkladný
alley=ulička/průchod
furtive=kradmý/potutelný
foil=fólie/protějšek
extant=dochovaný/současný
undue=přehnaný/neoprávněný/před splatností
logger=dřevorubec/zapisovač dat
transgress=prohřešit se/porušit něco
fume=výpary/dým/hněv
makeshift=provizorní
assort=roztřídit
hoist=(vy)zvednout/(vy)zdvihnout
masonry=zdivo/zdění/zednářství
ligament=šlacha/vaz/vazivo
hawker=pouliční prodavač
vend=prodat pouličně
wend=ubírat se/směřovat
cautionary=varovný/výstražný
co-opt=kooptovat/přibrat k sobě
bark=štěkat/kůra
hark=naslouchat pozorně
ample=dostatečný/bohatý
moan/bemoan=naříkat/lamentovat
unicity=jednoznačnost/jednota/unikátnost
equity=čisté jméní společnosti/rovnsot/spravedlnost
sublate=negovat/odepřít
accrue=narůstat/nahromadit se
conjure=vyčarovat/kouzlit
imbue=naplnit/vštípit/dodad čemu co
eavesdrop=odposlouchávat
prudence/caution=opatrnost/obezřetnost
serf=nevolník
mind-boggling=ohromující/neuvěřitelný
abolish=zrušit/odstranit
parsimony=(přílišná) šetrnost/lakomost
heinous=hnusný/ohavný/odporný
repugnant=odpudivý/odporný
disgusting=nechutný/odporný
premeditate=promyslet/uvážit
slip=štěrbina/ruzparek/rozříznout
vest=tílko/vesta/udělit/propůjčit
rapport=vztah/vzájemné porozumění
tractable=zvladatelný/poddajný
divulge=prozradit/vyzradit
ostracize=vyloučit ze společnosti
cast aside=odvrhnout/odhodit
hegemony=uspořádání nadvlády
incriminate=poukozvat na/usvědčovat/obvinit
carousel=kolotoč
trailblazer=průkopník/pionýr
zeitgeist=duch doby
covet=prahnout/bažit
long/yearn=dychtit/toužit
dub=přezdívat
revile=zlořečit/spílat
sorority=sesterstvo
cuss=nadávat komu/zaklít
decease=skon/smrt/zesnout
gratuitous=bezdůvodný/neopodstatněný
assail=napadat/kritizovat
attacker/assailant=útočník
holster=pouzdro (na pistoli/přístroj)
beneath=pod něčím
twirl=točit (se)/otáčet (se)
flick=mihnout se/kmitnout/švihnout
corroborate=potvrdit/dosvědčit
lemming=lumík
chisel=dláto/otesávat/ošulit
pretence=předstírání/přetvářka/zástěrka
lineal=v přímé linii/dědičný
kinship=příbuzenství/spřízněnost
kin=příbuzní/příbuzenstvo
due=kvůli/následkem/náležitý/patřičný
cope=zvládnout co/vypořádat se s
accrue=narůstat/(na)hromadit se
article=článek/druh (zboží)/člen
neuter=bezpohlavní/střední rod/zbavit moci
declension=skloňování (slov)/odmítnutí/ústup
predicate=tvrzení/tvrdit/přásudek
pleasantry=zdvořilosti/zdvořilostní obraty/žert
convulsion=křeč/otřesy/nepokoje
accede=přistoupit/vyhovět/připojit se
interloper=vetřelec/nevítaný návštěvník
interlude=mezidobí/mezihra
gnarly=ošlehaný/drsný
raven=zhltnout/krkavec
ravenous=hltavý/žravý
hatch=líhnout se/klubat se/vysadět
