abyss=propast
cliff=útes
trace=stopa
cabbage=zelí
confection=cukroví
confections=cukrovinky
construe=chapat/vykladat
purport=znamenat/význam
entail=znamenat
adjunct=doplněk
acquaintance=známost
corporeal=tělesný
imperative=nezbytný
appease=upokojit
aptitude=nadání
turd=hovno
conduit=potrubí
resurgence=obnova
vacuous=prázdný
acknowledge=priznat/uznat
repent=kát se
fornicate=smilnit
conundrum=hádanka
walrus=mrož
sea lion=lachtan
seal=tuleň
whopper=flák
plumage=opeření
feather=peří/pero
gaze=zírat
sludge=kal
veal=telecí
adultery=cizoložství
endow=obdařit
pattern=vzor
gloss=lesk
regret=lítost
remorse=výčitka
violin=housle
equanimity=vyrovnanost
sect=sekta
hearsay=zvěst
pronouncement=prohlášení
botch=zpackat
veracity=pravdomluvnost
shackle=(s)poutat/pouta
reverence=úcta
smattering=polovzdelany/castecny
contraception=antikoncepce
beacon=maják
banner=prapor
anthem=hymna
prevalent=převládající
prevalence=převládání
trench=příkop/zákop
truncheon=pendrek
baton=obušek
club=kyj
bat=pálka
yield=vynášet/výnos/podlehnout
ductile=tvárný
perennial=trvalý
wimp=slaboch
credulity=důvěřivost
consecutive=po sobě jdoucí
prissy=upjatý
counterfeit=padělaný
gross=hrubý
drought=sucho
marine=mořský
pluck=utrhnout
plucky=kurážný
clutch=spojka
grueling=vysilující
tenacity=houževnatost
mediate=zprostředkovat
mediated=zprostředkovaný
avarice=lakomství
replete=naplněný
relegate=odsunout/degradovat
consign=poslat člověka/svěřit
celestial=nebeský
effigy=zpodobení
pillar=pilíř
stellar=hvězdný
plateau=náhorní rovina
influence=vliv
prelude/overture=předehra
freewheeling=volnoběh
gaudy=křiklavý
plunge=ponořit se
immerse=pohroužit se
turmoil=zmatek/vřava
tray=zásobník
pot=hrnec/konvice
trip=výlet
exquisite=nádherný/vynikající
onslaught=prudký útok
recall=vzpomínat
numeral=číslovka
