snap=prasknout/chnapnout/odseknout
stoop=hrbit se/ohnout se
buckle=kroutit se/ohnout se/pripnout/prezka
crony=kumpan
cronyism=bratrickovani/system ruka ruku myje
fringe=ofina/trasne/okrajovy
cringe=otrepat se/osivat se odporem v neprijemne/trapne situaci
smudge=smouha/skvrna
stain=skvrna/flek
umbilicus/navel=pupek/pupik
furnace=hutni pec
forge=vypracovat/kovarna
quaint=malebny/sverazny/osobity
adorn=zdobit/zkraslit
unadorned=prosty/nezdobeny
subsume=zaclenit/zaradit
echelon=uroven/vrstva
derangement=vysinuti
ration=pridel/davka
veer=stocit se/zmenit smer
paved=(vy)dlazdeny
rash=ukvapeny/zbrkly
punctilious=puntickarsky/uzkostlive peclivy
clergy=duchovenstvo/duchovni
aggravate=zhorsit/ztizit
ostensive=definovany ukazanim na priklad
equivocal=dvojznacny/nejasny/vyhybavy
inscribe=napsat/vyrit/vytesat
gobble=hltate/hltave jist
dainty=roztomily/libezny
provincial=venkovsky/zaostaly/malomestak
jabber=brebentit/drmolit
coast=pobrezi/morsky breh
growl/snarl=vrcet
curtail=omezit/zredukovat
despoil=vyplenit/vyloupit
nebulous=mlhavy/nejasny/mlhovinovy
inexorable=neuprosny/nezadrzitelny
wedge=zaklinovat/vklinit
fuss=povyk/poprask
stupefy=omracit/ohromit
stupefied=ohromeny
draw=kreslit/tahnou
overdue=zpozdeny/opozdeny
overdrawn=precerpany
ferry=trajekt/prevozni lod
ferrying=privoznictvi
arrogate=uzurpovat/osobovat si
impute=prisuzovat/pricitat/pricitat
rabid=fanaticky/vztekly
harrow=vyplenit/zpustosit/brany(naradi)/vlacet
embroil=zaplest/vtahnout
rig=zmanipulovat/ovlivnit/vybavit lod/vrtna souprava
funnel=trychtyr/nalevka
hustle=postrkovat/spechat
hustler=sejdir/podvodnik/podnikavec
spook=duch/strasidlo
indefinite=neomezeny/nevymezeny/neurcity
whatnot=ja nevim/co jeste
univalent=jednomocny
impetus=popud/podnet
attend=zucastnit se
reticule=kabelka
cobble=dlazebni kostka
crane=jerab
tremp=tulak/vandrak
deplorable=zalostny/mizerny
truism=zrejma pravda/otrepana pravda
tedious=nudny/unavny
meagre=ubohy/mizerny/hubeny
prowess=zdatnost
prospect=vyhlidka/sance
prospective=vyhledovy/potencialni
expat/expatriate=vystehovalec/emigrant
expatiate=vykladat ze siroka
tranquility=klid/pokoj
barter=smenovat/smenny obchod
policy=politika/strategie
jumbled=zprehazeny/neusporadany
eschew=vyhnout/vyhybat (se)
affinity=blizky vztah
rudiment=zaklad/y
percolate=prosakovat
survey=pruzkum/dotazovani/anketa
purvey=sirit
glee=sirit/dodavat
overarching=pojici/ustredni
ulterior=postranni/vedlejsi/skryty
zest=radost/nadseni/elan
zestful=full of energy and enthusiasm
visage=vzhled/tvar
envisage=predstavovat si/videt
tractable=poddajny/snadno ovladatelny
intractable=nepoddajny/zarputily
overt=otevreny/neskryvany
apprehend=zadrzet/dopadnout
demonstrable=prokazatelny/zrejmy
plunger=zvon/pist
throttle=klapka/ventil
occasion=prilezitost/udalost
