serene=klidný
belligerent=útočný/agresivní
girdle=pásek/opasek
girth=obvod pasu/stromu
griddle=panev/plotna
stencil=šablona
denim=džínovina
morgue=márnice
obituary=nekrolog
squish=rozmáčknout
squirm=kroutit se
betrothed=zasnoubený/zaslíbený
equivocation=vyhybave reci
insouciant=bezstarostný/nenucený
sermons=kázání
gabble=žvanit
scaffold=lešení
plaque=plaketa
slouch=schlíplý
obtrusive=dotěrný/vtiravy
unobtrusive=nenápadný/decentní
reverent=uctivý
flagrant=kriklavy/zjevny
pediment=trojuhelnikovy stit
discern=rozeznat
sassy=drzý
glare=oslnit
complacent=spokojený/samolibý
proliferate=množit
efface=smazat
prurience=chlípnost
hallmark=punc
rearing=chov
bulwark=val
grief=smutek
grim=chmurný
grievely=žalostně
grieve=truchlit
grave=závažný/hrob
pavement=chodník/dlažba
looming=hrozivý
loom=tyčit se/být na obzoru/hrozit
miniscule=miniaturní
eddy=vír
judicious=soudný/rozumný
clutter=nepořádek
allusion=narážka
stretch=úsek/protáhnout
muster=sehnat/shromáždit
splendid=ohromny/bajecny
wring=ždímat/kroutit
putative=předpokládaný
plot/scheme/intrigue=intrika
illicit=nedovolený/pokoutní
bosh=blbost
mold/mould=forma/plíseň
perspicuous=zřetelný
outset=začátek/úvod
glimpse=záblesk
preposition=předložka
endearment=projev náklonnosti
fond=mající rád
rattle=chrastit/chřestit
gust=poryv/závan
avid=zanícený
grievance=pocit křivdy
dastard=podvodník/zbabělec
underhanded=podloudny
flair=cit/vkus
frail=křehký/slabý
aberration=odchylka
daft=pitomý
uncontentious=nesporný
inscription=nápis
bottle up=potlačovat
converse=opačný
enquiry=šetření
snub=sjet/plísnit/krátký a zahnutý nahoru(nos)
frivolous=povrchní
perspicuity=srozumitelnost
swoop=vrhnout se/přepadnout
sweep=mést/máchnout
scribble=načmárat/naškrábat
riposte=odvetit/pohotová reakce/odseknout
murky=šerý/temný
crisply=pevně a hladce
crisp=pevný a hladký/křupat
crispy=křupavý
crumple=zmuchlat
demeanor=chování/vystupování
manner=způsob
marvelous=skvělý/úžasný
marvel=zázrak/žasnout
erogenous=erotogenní
inflect=ohýbat (se)/skloňovat
irreconcilable=neslučitelné
inflammation=zánět
suffocate=udusit se
asphyxiate=zadusit
strangle=rdousit/škrtit
