bludgeon=obušek/klacek
demonstrative=ukazovací/otevřený/objasňující
misnomer=nesprávené pojmenování/název
expenditure=výdaje/finanční náklad/vynaložení
acquit=zprostit viny/osvobodit/zbavit/splatit
paroxysm=záchvat/nával/výbuch
ravish=znásilnit/uchvátit/zprznit
appropriate=odpovídající/uzmout
approbate=schválit/formálně uznat
lament=bědovat/naříkat
astound=ohromit/udivit
soothsayer=věštec/jasnovidec
delve=zašít pátrat/zalovit
berate=vynadat/vyhubovat/spílat
prodigious=zázračný/úžasný
contraption=udělátko/pomůcka/vynález
confer=radit se/udělit
bordering=hraničící s/obrubování
thaw=tát/rozmrznout
masquerade=přestrojit se/maškaráda
uterus/womb=děloha
jar=rozčilovat/štvát/třást
jarring=rozčilující/nepřájemný/střásání
confluence=soutok/souběk/splynutí/dav
misconstrue=špatně si vyložit/nepochopit
unified=sjednocený/jednotný
hanker=toužit/prahnout/dychtit
buoy=bóje/nadnášet/povzbudit
fry=smažit/potěr
cessation=zanechnání/zastavení
sham=předstírat/švindl
flank=bok/křídlo/úbočí
binge=hýření/oddat se
mired=ponořený/zablácený
mire=marast/bahno
quintessential=typický/podstatu tvořící
teeter=vrávorat/kymácet se/balancovat
furbish=vyleštit/nablýskat
burnish=leštit (kov)/lesknout se
wrongdoer=provinilec/pachatel
misfortune=neštěstí/rána osudu
rabble-rouser=buřič/štváč
deliberation=uvažování/zvažování
rehearse=koušet/nacvičovat
artery=tepna
interrogation=výslech/vyslýchání
investigation=vyšetřování/šetření
abbot=opat
adulterated=znehodnocený/pančovaný/ředěný
slew=spousta/smýknout se
unadulterated=čistý/ryzí/neředěný
flimsy=chatrný/povrchní/slabý
evince=ukazovat/dávat najevo/svěčit
vantage=výhoda/výhodná pozice
multitude=spousta/mnoho/zástup
whereby=kterým/jímž/pomocí něhož
cull=vybrat/odebrat/zredukovat
rumble=rachotit/burácet
adjutant=pobočník
ingress=vstupování/vstoupit/vtok
luster/lustre=lustr/lesk/třpyt
prattle=žvanit/žvatlat
emasculate=oslabit/vykastrovat
barley=ječmen
defect=vada/zběhnout
deflect=odvrátit/odrazit
engrossed=zabraný/pohroužený/upoutaný
plead=hájit čím/naléhavě žádat
sponge=mycí houba/mořská houba
tilth/tillage=orba/kultivace/obdělávaná půda
spectacle=pohled/podívaná
spectacular=působivý/velkolepý
coax=přemluvit/přimět
presume=předpokládat/domnívat se/dovolit si
conciliation=(u)smíření/(snaha o) smír
explicate=vysvětlit/rozebrat logicky
instate=dosadit/unstanovit
reinstate=dosadit zpět/znovu zavést
congeal=ztuhnout/srazit se
pedigree=rodokmen/původ
conciliatory=
caries=zubní kaz/zánět kosti
presumptuous=troufalý/smělý
razz=dobírat si/udtahovat si
itinerary=cestovní trasa/cestovní plán
tote=třímat/nosit
fluting=melodický/zpěvný/žlábkování/žlábkovací
flute=flétna/rýha/žlábek
insipit=bez chuti/mdlé chuti/nevýrazný
resent=nesnášet/nelibě nést
sleight=deceitful craftiness/dexterity/skill
polity=uskupení/zřízení/občanský řád
grouse=bručet/remcat
barn=stodola/stáj/vozovna
twitch=cuknout/škubnout
latent=skrytý/latentní
quell=potlačit/uklidnit
opacity=neprůhlednost/nepropustnost/nejasnost
despondent=sklíčený/skleslý/deprimovaný
nascent=rodící se/vznikající
